  #######  ####
###     ####  ######
#            $ #   #
# $$$ #$# ##    ...#
#  #  # $   #  #...#
## ####  $$ # ###..#
#  $ @ #   #  $ #..#
# $ #$ # #  $$  #..#
#   # # $ $# $  #..#
##### #    #  $#...#
  #   ### ###  ##..#
  # # $       ######
  #   ##  ##  #
  #############